#######
#     #
#@ $. #
#     #
#######
; 1