#####
#@$.#
#####
; 1

#######
#     #
#@ $. #
#     #
#######
; 2